2222222222
2000000002
2000001102
2000000102
2000000002
2000000202
2111000002
2000000002
2000000102
2222222222