1111111111
1000000001
1000001101
1000000101
1000000001
1000000201
1111000001
1000000001
1000000101
1111111111