33333333333333333333
30023000000000000023
30013000000000000003
33003210010010010003
30000000000000000003
30000000000000000003
30000000000000000003
30000000000000000003
30000001133000000003
32000001133000000023
33120001111000000003
30000000000000000003
30000000000000033333
30000000000000000003
30000000000000000003
30000000000000000003
32211000000000011223
31000000000000000013
30000000000000000003
33333333333333333333