3333333333
3000000003
3220001203
3000000103
3000000003
3000000303
3111000003
3000000003
3200000103
3333333333