33333333333333333333
30000000000000000003
30000000000000000003
30010010010010010003
30000000000000000003
30000000000000000003
30000000000000000003
30000000000000000003
32000000033000000003
30000000033000000023
30000000000000000003
30000000000000000003
30000000000000000003
30000000000000000003
30000000000000000003
30000000000000000003
32211000000000011223
31000000000000000013
30000000000000000003
33333333333333333333